// ====  ALL CRITERION FOR SET 0 CORE IMP RESPONSES  ====================================================================================================
// ======================================================================================================================================================

criterion "NoRepeatForPlayerCommonResponses"	"NoRepeatForPlayerCommonResponses" "!=1" required
criterion "NoRepeatForOpponentCommonResponses"	"NoRepeatForOpponentCommonResponses" "!=1" required

criterion "NoRepeatForPlayerAttackBuff"	"NoRepeatForPlayerAttackBuff" "!=1" required
criterion "NoRepeatForPlayerArmorBuff"	"NoRepeatForPlayerArmorBuff" "!=1" required
criterion "NoRepeatForPlayerSiegeBuff"	"NoRepeatForPlayerSiegeBuff" "!=1" required
criterion "NoRepeatForPlayerCleaveBuff"	"NoRepeatForPlayerCleaveBuff" "!=1" required
criterion "NoRepeatForPlayerHealBuff"	"NoRepeatForPlayerHealBuff" "!=1" required
criterion "NoRepeatForPlayerImmuneBuff"	"NoRepeatForPlayerImmuneBuff" "!=1" required
criterion "NoRepeatForOpponentAttackBuff"	"NoRepeatForOpponentAttackBuff" "!=1" required
criterion "NoRepeatForOpponentArmorBuff"	"NoRepeatForOpponentArmorBuff" "!=1" required
criterion "NoRepeatForOpponentImmuneBuff"	"NoRepeatForOpponentImmuneBuff" "!=1" required

criterion "NoRepeatForPlayerTimerBasedClockResponses"	"NoRepeatForPlayerTimerBasedClockResponses" "!=1" required
criterion "NoRepeatForPlayerTimerBasedWinLoseIdleResponses"	"NoRepeatForPlayerTimerBasedWinLoseIdleResponses" "!=1" required
criterion "NoRepeatForOpponentTimerBasedClockResponses"	"NoRepeatForOpponentTimerBasedClockResponses" "!=1" required
criterion "NoRepeatForOpponentTimerBasedWinLoseIdleResponses"	"NoRepeatForOpponentTimerBasedWinLoseIdleResponses" "!=1" required

criterion "isPlayer10SecondsRemainingCurrentlyActive"	"isPlayer10SecondsRemainingCurrentlyActive" "1" required
criterion "isOpponent10SecondsRemainingCurrentlyActive"	"isOpponent10SecondsRemainingCurrentlyActive" "1" required

criterion "IsWaitingToPlayPlayerTowerDeathSkullResponses"	"IsWaitingToPlayPlayerTowerDeathSkullResponses" "!=1" required
criterion "IsWaitingToPlayOpponentTowerDeathSkullResponses"	"IsWaitingToPlayOpponentTowerDeathSkullResponses" "!=1" required
criterion "IsWaitingToPlayPlayerTowerDeathSkullResponsesFromTimer"	"IsWaitingToPlayPlayerTowerDeathSkullResponsesFromTimer" "!=1" required
criterion "IsWaitingToPlayOpponentTowerDeathSkullResponsesFromTimer"	"IsWaitingToPlayOpponentTowerDeathSkullResponsesFromTimer" "!=1" required


criterion "IsChainingToPlayerLocalTowerHasDeathSkulllIntro"	"IsChainingToPlayerLocalTowerHasDeathSkulllIntro" ">0" required
criterion "IsChainingToPlayerLocalTowerHasDeathSkullIdle"	"IsChainingToPlayerLocalTowerHasDeathSkullIdle" ">0" required
criterion "IsChainingToPlayerOpponentTowerHasDeathSkullIntro"	"IsChainingToPlayerOpponentTowerHasDeathSkullIntro" ">0" required
criterion "IsChainingToPlayerOpponentTowerHasDeathSkullIdle"	"IsChainingToPlayerOpponentTowerHasDeathSkullIdle" ">0" required
criterion "IsChainingToOpponentLocalTowerHasDeathSkullIdle"	"IsChainingToOpponentLocalTowerHasDeathSkullIdle" ">0" required


criterion "NoRepeatLocalTowerHasDeathSkullIdle"	"NoRepeatLocalTowerHasDeathSkullIdle" "!=1" required
criterion "NoRepeatOpponentTowerHasDeathSkullIdle"	"NoRepeatOpponentTowerHasDeathSkullIdle" "!=1" required


criterion "IsChainingToPlayerPauseLoop"	"IsChainingToPlayerPauseLoop" ">0" required
criterion "IsChainingToOpponentPauseLoop"	"IsChainingToOpponentPauseLoop" ">0" required

criterion "IsChainingToPlayerOpponentTowerDestroyed"	"IsChainingToPlayerOpponentTowerDestroyed" ">0" required
criterion "IsChainingToPlayerTowerDestroyed"	"IsChainingToPlayerTowerDestroyed" ">0" required

criterion "IsWaitingToPlayPlayerNumberOfUnitsResponses"	"IsWaitingToPlayPlayerNumberOfUnitsResponses" "!=1" required
criterion "IsWaitingToPlayPlayerNumberOfUnitsResponsesFromTimer"	"IsWaitingToPlayPlayerNumberOfUnitsResponsesFromTimer" "!=1" required
criterion "IsWaitingToPlayOpponentNumberOfUnitsResponses"	"IsWaitingToPlayOpponentNumberOfUnitsResponses" "!=1" required
criterion "IsWaitingToPlayOpponentNumberOfUnitsResponsesFromTimer"	"IsWaitingToPlayOpponentNumberOfUnitsResponsesFromTimer" "!=1" required


criterion "IsWaitingToPlayPlayerNumberOfUnitsIdleResponses"	"IsWaitingToPlayPlayerNumberOfUnitsIdleResponses" "!=1" required
criterion "IsWaitingToPlayOpponentNumberOfUnitsIdleResponses"	"IsWaitingToPlayOpponentNumberOfUnitsIdleResponses" "!=1" required


criterion "IsChainingToPlayerNoLocalUnitsIdleLoop"	"IsChainingToPlayerNoLocalUnitsIdleLoop" ">0" required
criterion "IsChainingToPlayerNoOpponentUnitsIdleLoop"	"IsChainingToPlayerNoOpponentUnitsIdleLoop" ">0" required


criterion "IsChainingToPlayerLoseIdleLoop"	"IsChainingToPlayerLoseIdleLoop" ">0" required

criterion "IsChainingToPlayerWaitGameVictory"	"IsChainingToPlayerWaitGameVictory" ">0" required

criterion "IsChainingToPlayerBlinkReturn"	"IsChainingToPlayerBlinkReturn" ">0" required


criterion "o_var_hold_blue_button" "o_var_hold_blue_button" "!=1" required
criterion "p_var_hold_blue_button" "p_var_hold_blue_button" "!=1" required
criterion "p_var_chains_dev_blue_button_" "p_var_chains_dev_blue_button_" ">0" required